灰赤黄金	はいあかききん
青灰黄金	あおはいききん
黄紫黄金	きむらさきききん
橙橙黄金	だいだいだいだいききん
赤赤黄金	あかあかききん
茶緑黄金	ちゃみどりききん
茶黒黄金	ちゃくろききん
灰赤橙金	はいあかだいだいきん
青灰橙金	あおはいだいだいきん
黄紫橙金	きむらさきだいだいきん
橙橙橙金	だいだいだいだいだいだいきん
赤赤橙金	あかあかだいだいきん
茶緑橙金	ちゃみどりだいだいきん
灰赤赤金	はいあかあかきん
青灰赤金	あおはいあかきん
黄紫赤金	きむらさきあかきん
橙橙赤金	だいだいだいだいあかきん
赤赤赤金	あかあかあかきん
茶緑赤金	ちゃみどりあかきん
灰赤茶金	はいあかちゃきん
青灰茶金	あおはいちゃきん
茶紫茶金	ちゃむらさきちゃきん
赤赤茶金	あかあかちゃきん
茶黒橙金	ちゃくろだいだいきん
茶黒赤金	ちゃくろあかきん
橙橙茶金	だいだいだいだいちゃきん
茶緑茶金	ちゃみどりちゃきん
茶黒茶金	ちゃくろちゃきん